ADub.III.73,ADub.III.83,ADub.III.84,F305-01,F305-07,F305-90,JSul.I.04,JSul.III.01,JSul.III.02,JSul.III.65,JSul.IV.02A,TKow.02
0,0,1,0,1,1,0,1,0,0,1,0
0,0,0,0,0,1,0,0,0,0,0,0
1,0,0,0,1,1,1,0,0,0,0,0
0,0,0,0,0,0,0,0,1,0,0,1
1,0,1,0,0,1,0,0,1,0,0,1
1,1,1,0,1,0,1,0,1,0,0,0
0,0,1,0,0,1,0,0,0,0,0,0
1,0,0,0,0,0,0,0,0,0,1,0
0,0,0,1,1,1,0,0,0,0,0,0
0,0,0,0,0,0,0,0,0,0,0,0
1,0,0,0,0,0,0,1,0,0,0,0
0,0,0,1,1,0,0,0,0,0,0,0
